##############################
#####......############....###
###.........#########.......##
#####..x......#####.......####
###....................y.....#
####......##.................#
#......#######...............#
##############################